...............
...............
...............
ZZ...........ZZ
...............
....ZZZZZZZ....
...............
...............
WW...........WW
.....LLLLL.....
.......B.......
LLL....B....LLL
.B.1...B...2.B.
GGGGGGGGGGGGGGG
GGGGGGGGGGGGGGG