...............
...............
...............
WWW.........WWW
...............
....ZZZZZZZ....
W.............W
...............
WW....ZZZ....WW
...............
WWW.........WWW
...............
..1.........2..
ZZZZZZZZZZZZZZZ
...............