...............
...............
..WW....W......
..............W
...WWWWWWWWW...
...............
WW....WW....WWW
.........W.....
.WWWW.........W
........WWWW...
..WW...........
.....WWW.......
..1.......2....
GGGGGGGGGGGGGGG
GGGGGGGGGGGGGGG
