............................
............................
..........WWWWW.............
....WWW.............WWWW....
............WWW.............
..................WWW.......
........WWW.....W...........
..WWW...........W...........
............W......WWW......
......WW......T.............
............WWWWW...........
....WWWW............WWWW....
.......1..............2.....
GGGGGGGGGGGGGGGGGGGGGGGGGGGG
GGGGGGGGGGGGGGGGGGGGGGGGGGGG