............................
..........WWWWWWW...........
............................
............................
..ZZZZZZZZZZZZZZZZZZZZZZZZ..
............................
............................
WWWWW..................WWWWW
..............T.............
...........WWWWWW...........
....WWWW............WWWW....
.......1..............2.....
ZZZZZZZZZZZZZZZZZZZZZZZZZZZZ
............................
............................