...............
.....ZZZZZ.....
...............
ZZ...........ZZ
...............
....ZZZZZZZ....
...............
...............
WW...........WW
.....WZZZW.....
.WW.........WW.
...............
..1...WWW..2...
ZZZZZWWWWWZZZZZ
...............