...............
...............
..WW....W......
...........2..W
...WWWWWWWWW...
...............
WW....WW....WWW
.........W.....
.WWWW.........W
........WWWW...
..WW...........
.....WWW.......
..1............
GGGGGGGGGGGGGGG
GGGGGGGGGGGGGGG
