...............
...............
WWWWWWW.WWWWWWW
...............
...............
..ZZZZZZZZZZZ..
...............
S.............S
S....SSSSS....S
S1...........2S
SSSS.......SSSS
S.............S
S.....SSS.....S
WWWWWWWWWWWWWWW
...............