...............
...............
...............
LLL.........LLL
...............
1...LLLLLLL...2
G......B......G
G......B......G
LL.....B.....LL
.......B.......
.....ZZZZZ.....
LL.....B.....LL
GGLL...B...LLGG
GGGGGGGGGGGGGGG
GGGGGGGGGGGGGGG