............................
............................
..........WWWWW.............
....WWW.............WWWW....
............WWW.............
..................WWW.......
.................W..........
................W...........
............W...............
......WW....................
............WWWWW...........
...................WWWW.....
.......1..............2.....
GGGGGGGGGGGGGGGGGGGGGGGGGGGG
GGGGGGGGGGGGGGGGGGGGGGGGGGGG