....................................................................................................................................................................
....................................................................................................................................................................
....................................................................................................................................................................
....................................................................................................................................................................
....................................................................................................................................................................
....................................................................................................................................................................
....................................................................................................................................................................
....................................................................................................................................................................
....................................................................................................................................................................
....................................................................................................................................................................
................................W.....WWWWWWWWWWWWWW................................................................................................................
..............................WWW...................................................................................................................................
...P......W........E.........WWWW...................................................................................................................................
GGGGGGGGGGGGGGGGGGGGGGGG...GGGGGG....WWWWWWWWWWWWW...GGGGGGGGGGGGGGGGGGGGGGGGGGGGGGGGGGGGGGGGGGGGGGGGGGGGGGGGGGGGGGGGGGGGGGGGGGGGGGGGGGGGGGGGGGGGGGGGGGGGGGGGGGGGGGG
....................................................................................................................................................................